patient,score 1,score 2,score 3
160,0,0,0
161,2,2,0
162,1,1,1
163,2,2,0
164,0,0,0
165,1,0,1
166,1,2,1
167,2,1,0
168,1,0,0
169,1,0,1
170,12,0,0
171,2,2,2
172,2,2,2
173,1,0,0
174,2,0,2
175,1,1,0
176,2,2,2
177,1,0,1
178,2,0,0
179,1,1,1
180,1,1,1
181,2,0,2
182,12,0,12
183,2,2,0
184,12,12,12
185,1,1,0
186,1,0,0
187,2,0,2
188,1,1,1
189,12,0,0
190,1,1,0
191,2,0,2
192,1,1,1
193,12,12,0
194,12,0,12